##########
####O#####
####OBC###
####POBC##
####OOC###
####O#B###
####OOO###
##########
