##########
##C###OO##
##O###OB##
##COO#OO##
##OOBOOOO#
##OBOPCOO#
##OO######
##########
