##########
######OO##
#OOOOOBO##
#OCCOOOO##
#OBCOOO###
##OPOOB###
#####OO###
##########
